"filename", "language", "TypeScript JSX", "SCSS", "comment", "blank", "total"
"d:\HypeFans\hypefans_frontend\src\components\screens\home\post\postItem\PostItem.module.scss", "SCSS", 0, 20, 0, 5, 25
"d:\HypeFans\hypefans_frontend\src\components\screens\home\post\postItem\PostItem.tsx", "TypeScript JSX", 90, 0, 0, 11, 101
"d:\HypeFans\hypefans_frontend\src\components\screens\home\post\postItem\postComments\PostComments.module.scss", "SCSS", 0, 28, 0, 5, 33
"d:\HypeFans\hypefans_frontend\src\components\screens\home\post\postItem\postComments\PostComments.tsx", "TypeScript JSX", 78, 0, 1, 13, 92
"d:\HypeFans\hypefans_frontend\src\components\screens\home\post\postItem\postComments\postCommentForm\PostCommentForm.module.scss", "SCSS", 0, 32, 0, 8, 40
"d:\HypeFans\hypefans_frontend\src\components\screens\home\post\postItem\postComments\postCommentForm\PostCommentForm.tsx", "TypeScript JSX", 77, 0, 0, 15, 92
"d:\HypeFans\hypefans_frontend\src\components\screens\home\post\postItem\postComments\postCommentItem\PostCommentItem.module.scss", "SCSS", 0, 35, 0, 4, 39
"d:\HypeFans\hypefans_frontend\src\components\screens\home\post\postItem\postComments\postCommentItem\PostCommentItem.tsx", "TypeScript JSX", 36, 0, 4, 10, 50
"d:\HypeFans\hypefans_frontend\src\components\screens\home\post\postItem\postComments\postCommentItem\postCommentActions\PostCommentActions.module.scss", "SCSS", 0, 10, 0, 1, 11
"d:\HypeFans\hypefans_frontend\src\components\screens\home\post\postItem\postComments\postCommentItem\postCommentActions\PostCommentActions.tsx", "TypeScript JSX", 36, 0, 0, 8, 44
"d:\HypeFans\hypefans_frontend\src\components\screens\home\post\postItem\postComments\postCommentList\PostCommentList.module.scss", "SCSS", 0, 13, 0, 1, 14
"d:\HypeFans\hypefans_frontend\src\components\screens\home\post\postItem\postComments\postCommentList\PostCommentList.tsx", "TypeScript JSX", 31, 0, 0, 4, 35
"d:\HypeFans\hypefans_frontend\src\components\screens\home\post\postItem\postContent\PostContent.module.scss", "SCSS", 0, 19, 0, 3, 22
"d:\HypeFans\hypefans_frontend\src\components\screens\home\post\postItem\postContent\PostContent.tsx", "TypeScript JSX", 44, 0, 0, 10, 54
"d:\HypeFans\hypefans_frontend\src\components\screens\home\post\postItem\postContent\postMediasModal\PostMediasModal.module.scss", "SCSS", 0, 0, 0, 1, 1
"d:\HypeFans\hypefans_frontend\src\components\screens\home\post\postItem\postContent\postMediasModal\PostMediasModal.tsx", "TypeScript JSX", 38, 0, 0, 10, 48
"d:\HypeFans\hypefans_frontend\src\components\screens\home\post\postItem\postHeader\PostHeader.module.scss", "SCSS", 0, 28, 0, 5, 33
"d:\HypeFans\hypefans_frontend\src\components\screens\home\post\postItem\postHeader\PostHeader.tsx", "TypeScript JSX", 52, 0, 0, 9, 61
"d:\HypeFans\hypefans_frontend\src\components\screens\home\post\postList\PostsList.module.scss", "SCSS", 0, 15, 0, 2, 17
"d:\HypeFans\hypefans_frontend\src\components\screens\home\post\postList\PostsList.tsx", "TypeScript JSX", 72, 0, 0, 9, 81
"d:\HypeFans\hypefans_frontend\src\components\screens\home\post\postModal\PostModal.module.scss", "SCSS", 0, 7, 0, 2, 9
"d:\HypeFans\hypefans_frontend\src\components\screens\home\post\postModal\PostModal.tsx", "TypeScript JSX", 33, 0, 0, 7, 40
"Total", "-", 587, 207, 5, 143, 942